+-+-+-+-+-+-+-+-+-+-+-+-+-+-+-+-+-+-+-+-+-+-+-+-+-+-+-+-+-+-+-+-+-+-+-+-+-+-+-+-+
|S                                                                             E|
+                                                                               +
|                        O                                                      |
+                                                                               +
|                                                                               |
+                                                                               +
|                                                                               |
+                                                                               +
|                                                                               |
+                                                                               +
|                                                                               |
+                                                                               +
|                                                                               |
+                                                                               +
|                                                                               |
+                                                                               +
|                                                                               |
+                                                                               +
|                                                                               |
+                                                                               +
|                                                                               |
+                                                                               +
|                                                                               |
+                                                                               +
|                                                                               |
+                                                                               +
|                                                                               |
+                                                                               +
|                                                                               |
+                                                                               +
|                                                                               |
+                                                                               +
|                                                                               |
+                                                                               +
|                                                                               |
+                                                                               +
|                                                                               |
+                                                                               +
|                                                                               |
+                                                                               +
|                                                                               |
+                                                                               +
|                                                                               |
+                                                                               +
|                                                                               |
+                                                                               +
|                                                                               |
+                                                                               +
|                                                                               |
+                                                                               +
|                                                                               |
+                                                                               +
|                                                                               |
+                                                                               +
|                                                                               |
+                                                                               +
|                                                                               |
+                                                                               +
|                                                                               |
+                                                                               +
|                                                                               |
+                                                                               +
|                                                                               |
+                                                                               +
|                                                                               |
+                                                                               +
|                                                                               |
+                                                                               +
|                                                                               |
+                                                                               +
|                                                                               |
+                                                                               +
|                                                                               |
+                                                                               +
|                                                                               |
+                                                                               +
|                                                                               |
+                                                                               +
|                                                                               |
+-+-+-+-+-+-+-+-+-+-+-+-+-+-+-+-+-+-+-+-+-+-+-+-+-+-+-+-+-+-+-+-+-+-+-+-+-+-+-+-+