+-+-+-+-+-+-+-+-+-+-+-+-+-+-+-+-+
|#|#|P|#|#|P|#|P  |#|#|S  |#|#|#|
+-+-+ +-+-+ +-+=+-+-+-+   +-+-+-+
|#|#| |#|#| |#| |#|#| I   |#|#|#|
+-+-+=+-+-+=+-+ +-+-+ +-+-+-+-+-+
|#|                 | |#|#|#|#|#|
+-+-+-+-+-+-+-+ +-+-+ +-+-+-+-+-+
|#|#|#|#|#|#|#| |#|#| |#|#|#|#|S|
+-+-+-+-+-+-+-+ +-+-+ +-+-+-+-+ +
|#|#|#|#|#|#|#| |#|#| |#|#|#|#| |
+-+-+-+-+-+-+-+ +-+-+ +-+-+-+-+=+
|#|#|#|#|#|   I |#| I |#|S|#|   |
+-+-+-+-+-+-+-+ +-+-+ +-+ +-+   +
|#|#|#|#|P|#|#| |#|#| |#| |#|   |
+-+-+-+-+=+-+-+ +-+-+ +-+=+-+=+-+
|#|                           |#|
+-+-+=+-+-+-+-+ +-+-+ +-+=+-+-+-+
|#|#| |#|#|#|#| |#|#| |#|O|#|#|#|
+-+-+ +-+-+-+-+ +-+-+ +-+ +-+-+-+
|#|#| |#|#|   I |#|EI |#| |#|#|#|
+-+-+-+-+-+-+-+ +-+-+ +-+=+-+-+-+
|#|#|#|#|#|#|#| |#|#| |#|S  |#|#|
+-+-+-+-+-+-+-+ +-+-+ +-+   +-+-+
|#|#|#|#|#|#|#| I |#| |#|   |#|#|
+-+-+-+-+-+-+-+ +-+-+-+-+-+-+-+-+
|#|#|#|#|#|#|#| |#|#|#|#|#|#|#|#|
+-+-+-+-+-+-+-+ +-+-+-+-+-+-+-+-+
|#|#|#|#|#|#|#| |#|#|#|#|#|#|#|#|
+-+-+-+-+-+-+-+ +-+-+-+-+-+-+-+-+
|#|#|#|#|#|   I |#|#|#|#|#|#|#|#|
+-+-+-+-+-+   +-+-+-+-+-+-+-+-+-+
|#|#|#|#|#|   |#|#|#|#|#|#|#|#|#|
+-+-+-+-+-+-+-+-+-+-+-+-+-+-+-+-+