+-+-+-+-+-+-+-+-+-+-+-+-+-+-+-+-+
|#|#|P|#|#|S|#|O  |#|#|S  |#|#|#|
+-+-+ +-+-+ +-+=+-+-+-+   +-+-+-+
|#|#| |#|#| |#| |#|#| I   |#|#|#|
+-+-+=+-+-+=+-+ +-+-+ +-+-+-+-+-+
|#|                 | |#|#|#|#|#|
+-+-+-+-+-+-+-+ +-+-+ +-+-+-+-+-+
|#|#|#|#|#|#|#| |#|#| |#|#|#|#| |
+-+-+-+-+-+-+-+ +-+-+ +-+-+-+-+ +
|#|#|#|#|#|#|#| |#|#| |#|#|#|#| |
+-+-+-+-+-+-+-+ +-+-+ +-+-+-+-+=+
|#|#|#|#|#|   I |#|SI |#| |#|   |
+-+-+-+-+-+-+-+ +-+-+ +-+ +-+   +
|#|#|#|#|P|#|#| |#|#| |#| |#|   |
+-+-+-+-+=+-+-+ +-+-+ +-+=+-+=+-+
|#|                           |#|
+-+-+=+-+-+-+-+ +-+-+ +-+=+-+-+-+
|#|#| |#|#|#|#| |#|#| |#| |#|#|#|
+-+-+ +-+-+-+-+ +-+-+ +-+ +-+-+-+
|#|#| |#|#|   I |#|EI |#| |#|#|#|
+-+-+-+-+-+-+-+ +-+-+ +-+=+-+-+-+
|#|#|#|#|#|#|#| |#|#| |#|S  |#|#|
+-+-+-+-+-+-+-+ +-+-+ +-+   +-+-+
|#|#|#|#|#|#|#| I |#| |#|   |#|#|
+-+-+-+-+-+-+-+ +-+-+-+-+-+-+-+-+
|#|#|#|#|#|#|#| |#|#|#|#|#|#|#|#|
+-+-+-+-+-+-+-+ +-+-+-+-+-+-+-+-+
|#|#|#|#|#|#|#| |#|#|#|#|#|#|#|#|
+-+-+-+-+-+-+-+ +-+-+-+-+-+-+-+-+
|#|#|#|#|#|   I |#|#|#|#|#|#|#|#|
+-+-+-+-+-+   +-+-+-+-+-+-+-+-+-+
|#|#|#|#|#|   |#|#|#|#|#|#|#|#|#|
+-+-+-+-+-+-+-+-+-+-+-+-+-+-+-+-+