+-+-+-+-+-+-+-+-+-+-+-+-+-+-+-+-+
|#|#|#|#|#|#|#|#|#|#|#|#|#|#|#|#|
+-+-+-+-+-+-+-+-+-+-+-+-+-+-+-+-+
|#|#|#|#|   |#|  P|#|#|#|#|#|#|#|
+-+-+-+-+   +-+   +-+-+-+-+-+-+-+
|#|#|#|#|   |#|   |#|#|#|#|#|#|#|
+-+-+-+-+-+=+-+=+-+-+-+-+-+-+-+-+
|#|#|#|#|#|O|#| |#|#|#|#|#|#|#|#|
+-+-+-+-+-+ +-+ +-+-+-+-+-+-+-+-+
|#|#|#| |#| |#| |#|#|#|#|#|#|#|#|
+-+-+-+ +-+=+-+ +-+-+-+-+-+-+-+-+
|#|#|#| |#|   I |#|#|#|#|P|#|P  |
+-+-+-+ +-+-+-+ +-+-+-+-+ +-+   +
| |#|#| |#|#|#| |#|#|#|#| |#|   |
+ +-+-+ +-+-+-+ +-+-+-+-+=+-+=+-+
| I                      P    |#|
+-+-+-+ +-+=+-+ +-+-+=+-+-+-+-+-+
|#|#|#| |#| |#| |#|#| |#|#|#|#|#|
+-+-+-+ +-+ +-+ +-+-+ +-+-+-+-+-+
|#|#|#| |#| |#| |#| I |#|#|#|#|#|
+-+-+-+ +-+=+-+-+-+ +-+-+-+-+-+-+
|#|   I |#|   |#|#| |#|#|#|#|#|#|
+-+   +-+-+   +-+-+=+-+-+-+-+-+-+
|#|   |#|EI   |#|   |#|#|#|#|#|#|
+-+=+-+-+ +-+-+-+   +-+-+-+-+-+-+
|   |#|#| |#|#| I   I   |#|#|#|#|
+   +-+-+-+-+-+ +-+-+   +-+-+-+-+
|   |#|#|#|#|#| |#|#|   |#|   |#|
+-+-+-+-+-+-+-+-+-+-+-+=+-+   +-+
|#|#|#|#|#|#|#|#|#|#|#|S  I   |#|
+-+-+-+-+-+-+-+-+-+-+-+   +-+-+-+
|#|#|#|#|#|#|#|#|#|#|#|   |#|#|#|
+-+-+-+-+-+-+-+-+-+-+-+-+-+-+-+-+